BHLS		百货连锁系列
BHDD		百货单店系列,继承BHLS
BCRM		百货CRM系列,继承BHLS

BSTD		支持新促销模型的标准版系列

百货
BJYS		北京燕莎
JYBH		金瑶百货
SDYZ		山东银座
SFKS		上海富客斯FOXTOWN
SYSS		沈阳沈商折扣店
WJJY		威海家家悦
WQBH		万千百货
HZJB		杭州解百
SZXW		深圳西武百货
GZBH		广州百货
SQGT		宿迁国泰百货
TCRC		泰国CRC
BJSP		北京尚品
ZSBH		中商百货,继承BCRM
DXZY		新朝阳单品POS
NBBH        宁波二百

超市
AGOG		福建AGOGO超市
AJBS		驻马店爱家
BCSF		北京超市发
CDKG		承德宽广超市
HHDL		杭州汇德隆
LNBE		龙南百易
YBSJ		延百尚家
ZSPJ		中商平价

专卖
BSZM		深圳天天惠服装版本
LPPZ		良品铺子
JWYT		北京吴裕泰


